+------------------+
| F |         |  S |
|         | G |    |
|---+     +---+    |
|      @#          |
|   +---    ---+   |
| S |        S | G |
|   |          |   |
| G | S        | S |
|   |          |   |
|---+          +---+
|                G |
|   +---    ---+   |
| S |          | S |
|   |          |   |
| G |          | S |
|   |  GSGSGS  |   |
+------------------+