+------------------+
|     |      |     |
|  F  |      |  S  |
|     |      |     |
|     |  G   |     |
|     |  @   |     |
|     |  #         |
|              ----+
|  G               |
|           G      |
|                  |
|        S         |
|     |      G     |
|     |            |
|     |            |
|     |            |
| S   |        S   |
+-----+------------+