+------------------+
|     |      |     |
|  F  |      |  S  |
|     |      |     |
|     |  G   |     |
|     |  @   |     |
|     |  #   |     |
|              ----+
|                  |
|           G      |
|                  |
|        S         |
|     |      F     |
|     |            |
|     |            |
|     |            |
|     |            |
+-----+------------+