+------------------+
|                  |
|                  |
|                  |
|       G          |
|      F@S         |
|       #          |
|                  |
|                  |
|                  |
|                  |
|        S         |
|            F     |
|                  |
|                  |
|                  |
|                  |
+------------------+