+------------------+
|  F  |      |  S  |
|     |      |     |
|  G  +--  --+  G  |
|        @#        |
|     +--  --+     |
|  S  |      |  G  |
|     |      |     |
|  G  |      |  S  |
|     |      |     |
|  G  +--  --+  G  |
|                  |
|     +--  --+     |
|  S  |      |  S  |
|     |      |     |
|  S  |      |  S  |
|     |      |     |
+------------------+