+-----------------------+
|                       |
|  @#                   |
|                       |
|                       |
|      G                |
|                       |
|                       |
|                       |
|                       |
|                       |
|        S              |
|            F          |
|                       |
+-----------------------+