+-----------------------+
|                       |
|                       |
|                       |
|       G               |
|       @     S         |
|       #               |
|                       |
|                       |
|                       |
|                       |
|        S              |
|            F          |
|                       |
+-----------------------+