+------------------+
|  F  |      |  S  |
|     |      |     |
|  G  +--  --+  G  |
|        @#        |
|     +--  --+     |
|  S  |      |  F  |
|     |      |     |
|  F  |      |  S  |
|     |      |     |
|  G  +--  --+  G  |
|                  |
|     +--  --+     |
|  S  |      |  F  |
|     |      |     |
|  F  |      |  S  |
|     |      |     |
+------------------+