+------------------+
|                  |
|      G           |
|                  |
|    |   @#        |
|    |             |
|    |       F     |
|    |          G  |
|    |      |      |
|    |      |      |
|    |    F |      |
| S  |      |      |
|-----      |      |
|           |      |
|           | S    |
|           |      |
|   S    G  |      |
+------------------+