+------------------+
| F |   G S   | G  |
|   |     |   |    |
|---+     +---+    |
|      @#      S   |
|   +---   ---+    |
| S |    F    | F  |
|   |         |    |
|G  |    S    |  S |
|   |         |    |
|---+    G    +----+
|                F |
|   +---   ---+    |
| F |    S    | G  |
|   |         |    |
| G |    F    |  S |
|   |         |    |
+------------------+