+------------------+
|               G  |
|  F               |
|        ----      |
|            |     |
|         @  |  S  |
|         #  |     |
|        ----      |
|                  |
|   S       G      |
|     |            |
|     |            |
|     |            |
|               G  |
|                  |
|      S           |
|                  |
+------------------+