+------------------+
|                  |
|  S          G    |
|       G          |
|        @#        |
|                  |
|            S     |
|    S          G  |
|                  |
|                  |
|         F        |
|                  |
|    G             |
|                  |
|             S    |
|                  |
|   S    G         |
+------------------+